The image contains two illustrations. The larger one is a compass or directional diagram with the cardinal directions labeled. The smaller illustration depicts a person standing on a road with mountains or hills in the background.

ABCDEFGHIJKLMNOPQRSTUVWXYZ
AUG B 1960
DEPARTMENT OF THE AIR FORCE
UNITED STATES AIR FORCE
PROJECT BLUE BOOK
SPECIAL REPORT NO. 14
CASE NO: 6783115
LOCATION: KIRTLAND AFB, NEW MEXICO
DATE-TIME GROUP: 60-08-06
ABBREVIATIONS:
BB - Blue Book
AF - Air Force
NM - New Mexico
AFB - Air Force Base
RE - Reporting Eligible
NE - Not Evaluatable
WZ - Weatherization
MO - Month
GR - Ground Observer Corp
D - Day
Y - Year
H - Hour
M - Minute
S - Second
N - North
S - South
E - East
W - West
NW - Northwest
NE - Northeast
SW - Southwest
SE - Southeast
ESE - East Southeast
WSW - West Southwest