The image appears to be a photograph of a grid pattern, possibly from a radar screen or other technical equipment. The image is black and white and shows a dense grid of intersecting lines, creating a complex web-like structure. There are no identifiable human faces or other objects visible in the image.

As an OCR system, I have extracted the following text from the document:

STANDARD FORM 88
REPORT OF MEDICAL EXAMINATION

NAME - JENSEN, Cyrus Adin

AGE - 44

HEIGHT - 70" 

WEIGHT - 182 LBS.

RACE - CAUCASIAN

EYES - BROWN

HAIR - BROWN

COMPLEXION - FAIR

IDENTIFYING BODY MARKS, SCARS, TATTOOS - NONE

GENERAL APPEARANCE AND DEVELOPMENT - WELL DEVELOPED, WELL NOURISHED

TEMPERATURE - 98.0 F.

BLOOD PRESSURE - 130/90 MM/HG (SITTING)

PULSE AND RHYTHM - 72 REGULAR AND FULL

DISTANT VISION - RIGHT 20/20, LEFT 20/20, BOTH - 20/20

NEAR VISION - RIGHT 20/20, LEFT 20/20, BOTH - 20/20

OPHTHALMOSCOPIC - NEGATIVE

PUPILS - EQUAL AND REACT TO LIGHT AND ACCOMMODATION

EARS - HEARING ACUITY BILATERALLY NORMAL

DRUMS - INTACT AND MOBILE

NOSE, SINUSES, MOUTH AND THROAT - NORMAL

NECK - SUPPLE, THYROID NORMAL

LUNGS AND CHEST - CLEAR TO PERCUSSION AND AUSCULTATION 

HEART - REGULAR RATE AND RHYTHM, NO MURMURS OR ENLARGEMENT

ABDOMEN AND VISCERA - SOFT, NO MASSES OR TENDERNESS

UPPER EXTREMITIES - NORMAL 

LOWER EXTREMITIES - NORMAL

NEUROLOGIC - DEEP REFLEXES BRISK AND EQUAL BILATERALLY, ORIENTATION NORMAL, NORMAL CEREBELLAR FUNCTION

PSYCHIATRIC - NORMAL