There is no photograph present in the provided image. The image appears to be a page from an old UFO report document from Project Blue Book.

DETAILS:
1. This investigation is predicated upon AFCRL Letter No. 85, dated 13 August 1950, and OFF SCIEHTIFIC File No. 24-186.
AT ALBUQUERQUE, NEW MEXICO
2. Mr.[Redacted], University of New Mexico Student, 124 N. Arno, Albuquerque, New Mexico, was interviewed on 1 March 1950. The following information is a result of this interview:
Time and date of sighting: 2115 hours, 25 February 1950.
Point of observation: 600 N. Washington, Albuquerque, N.M., residence of Dr. [Redacted], sitting in living-room looking West.
Number of objects: One
What attracted attention: Attention drawn to objects.
Brightness of same: Bright greenish-white color; appeared to have a reddish-brown glow behind it.
Size: About three and a half as bright as a shooting star.
Shape: Tear drop shape with short tail.
Apparent constrictions: Unknown - appeared to be burning.
Distance of object from observer: Unknown - could have been 5 miles and it could have been 55 or more.
Angle of elevation from horizon: Approximately 20Â° above horizon.
Direction from observer: North-northwest to northeast-southsouthwest (almost straight down).
Tactics or maneuvers: None - fell straight down.
Evidence or trail of exhaust: Small trail of sky rocket effect.
Duration from observation to disappearance: sky.
Luminosity of object: Greenish-white like a parachute flare.
Apparent size of object: larger than a star.
Sounds and observations: None.
Speed: Slightly slower than falling star.
Sounds: None.
Odor: None.
Time in sight: One and a half seconds at most.
Manner of disappearance: Appeared to burn out.
Notes relating to observer: Observer is a student in Journalism at the University of New Mexico and is interested in strange air phenomena. That is why he became so interested in sighting of object.
3. All logical leads have been exhausted and this case is being closed.
- CLOSED -